hed_RA		=	RA
hed_DEC		=	DEC
hed_date	=	DATE-OBS
hed_filter1	=	CCDFLTID
hed_grism	=	GRISM
hed_object	=	OBJECT
hed_exptime	=	EXPTIME
hed_imagetyp	=	IMAGETYP
hed_expstar	=	EXPTIME
hed_JulianD	=	JD
hed_UT          =	TIME-OBS
hed_SideralTime =	LST
hed_telescope	=	TELESCOP
GAIN_value	=	2.3
RON_value	=	6.5
hed_instrume	=	INSTRUME
hed_airmass	=	SECZ
datamin_value   =	-100
datamax_value   =	60000
hed_slitw       =	SLIT
hed_lampid      =	LMP_ID
hed_biassec     =	BIASSEC
hed_trimsec     =	TRIMSEC
