hed_RA		=	RA
hed_DEC		=	DEC
hed_date	=	DATE-OBS
hed_filter1	=	FILTER
hed_grism	=	GRISM
hed_object	=	OBJECT
hed_exptime	=	EXPTIME
hed_imagetyp	=	TECH
hed_expstar	=	EXPTIME
hed_JulianD	=	JD
hed_UT          =	UT
hed_SideralTime =	LST
hed_telescope	=	TELESCOP
GAIN_value	=	1
RON_value	=	6.4
hed_instrume	=	TELESCOP
hed_airmass	=	AIRMASS
datamin_value   =	-100
datamax_value   =	60000
hed_slitw       =	SLIT
hed_lampid      =	LMP_ID
hed_biassec     =	BIASSEC
hed_trimsec     =	TRIMSEC
