hed_RA		=	RA
hed_DEC		=	DEC
hed_date	=	SHUTOUTC
hed_filter1	=	FILTER
hed_grism	=	ALGRNM
hed_object	=	OBSTYPE
hed_exptime	=	EXPTIME
hed_imagetyp	=	IMAGETYP
hed_expstar     =	EXPSTART
hed_JulianD	=	MJD-OBS
hed_UT  	=	SHUTOUTC
hed_SideralTime =	ST
hed_telescope	=	TELESCOP
GAIN_value      =	1.0785
RON_value       =	5.63
hed_instrume    =	INSTRUME
hed_airmass     =	AIRMASS
datamin_value   =	-200
datamax_value   =	23000
hed_OBSMODE	=	OBS_MODE
hed_chip	=	FPPOS
