hed_RA		=	RA
hed_DEC		=	DEC
hed_date	=	DATE-OBS
hed_filter1	=	INSFLNAM
hed_grism	=	INSGRNAM
hed_object	=	OBJECT
hed_exptime	=	EXPTIME
hed_imagetyp	=	IMAGETYP
hed_expstar	=	EXPSTART
hed_JulianD	=	JUL-DATE
hed_UT          =	UT_START
hed_SideralTime =	SID-TIME
hed_telescope	=	TELESCOP
GAIN_value	=	2.3
RON_value	=	5.06
hed_airmass	=	AIRMASS
hed_instrume	=	INSTRUME
datamin_value	=	-100
datamax_value	=	60000
hed_grismord	=	INSGRID
hed_lampid	=	INSCALNM
hed_slitw	=	SLIT
