hed_RA		=	RA
hed_DEC		=	DEC
hed_date	=	DATE-OBS
hed_filter1	=	FILTER
hed_grism	=	GRISM
hed_object	=	OBJECT
hed_exptime	=	EXPTIME
hed_imagetyp	=	INSTRUME
hed_expstar	=	EXPSTART
hed_JulianD	=	JD
hed_UT          =	UT
hed_SideralTime =	ST
hed_telescope	=	TELESCOP
GAIN_value	=	1.22
RON_value	=	4.87
hed_airmass	=	AIRMASS
hed_instrume	=	INSTRUME
datamin_value	=	-100
datamax_value	=	60000
hed_lampid      =	LAMP
