hed_RA		=	RA
hed_DEC		=	DEC
hed_date	=	DATE-OBS
hed_filter1	=	ACAMWH1
hed_filter2     =	ACAMWH2
hed_grism	=	ISIGRAT
hed_object	=	CAT-NAME
hed_exptime	=	EXPTIME
hed_imagetyp	=	IMAGETYP
hed_expstar	=	UTSTART
hed_JulianD	=	JD
hed_UT          =	UTSTART
hed_SideralTime =	ST
hed_telescope	=	TELESCOP
hed_cenwav	=	CENWAVE
hed_slitw	=	ISISLITW
GAIN_value	=	GAIN
RON_value	=	READNOIS
hed_airmass	=	AIRMASS
hed_instrume	=	INSTRUME
hed_dichroic    =	ISIBFOLD
datamin_value   =	-100
datamax_value   =	60000
hed_biassec     =	BIASSEC
hed_trimsec     =	TRIMSEC
hed_lampid      =	CAGLAMPS
hed_win		=	WINSEC1
hed_xbin	=	CCDXBIN
hed_ybin	=	CCDYBIN
