hed_RA		=	RA
hed_DEC		=	DEC
hed_date	=	DATE-OBS
hed_filter1	=	HIERARCH ESO INS OPTI-2 NAME
hed_grism	=	XXXX
hed_object	=	OBJECT
hed_exptime	=	EXPTIME
hed_imagetyp	=	IMAGETYP
hed_expstar     =	EXPSTART
hed_JulianD	=	MJD-OBS
hed_UT  	=	TM_START
hed_telescope	=	TELESCOP
GAIN_value      =	2
RON_value       =	3.6
hed_instrume    =	INSTRUME
hed_airmass     =	AIRMASS
datamin_value   =	-100
datamax_value   =	60000
hed_OBSMODE     =	OBS_MODE
hed_biassec     =	BIASSEC
hed_trimsec     =	[53:2098,1:2052]
hed_slitw	=	ALAPRTNM
hed_catlog      =	TCSTGT
