hed_RA		=	RA
hed_DEC		=	DEC
hed_date	=	DATE-OBS
hed_filter1	=	FILTER
hed_grism	=	GRISM
hed_object	=	OBJECT
hed_exptime	=	EXPTIME
hed_imagetyp	=	IMAGETYP
hed_expstar	=	EXPSTART
hed_JulianD	=	MJD-OBS
hed_UT          =	DATE-OBS
hed_SideralTime =	SID-TIME
hed_telescope	=	TELESCOP
GAIN_value	=	GAIN
RON_value	=	RDNOISE
hed_instrume	=	OBSERVAT
hed_airmass	=	AIRMASS
datamin_value   =	-100
datamax_value   =	49650
hed_slitw       =	SLT_ID
hed_lampid      =	LMP_ID
hed_biassec     =	BIASSEC
hed_trimsec     =	CCDSEC
