hed_RA		=	RA
hed_DEC		=	DEC
hed_date	=	DATE-OBS
hed_filter1	=	HIERARCH ESO INS FILT1 NAME
hed_grism	=	HIERARCH ESO INS OPTI2 NAME
hed_object	=	OBJECT
hed_exptime	=	EXPTIME
hed_imagetyp	=	HIERARCH ESO DPR TECH
hed_expstar	=	EXPTIME
hed_JulianD	=	MJD-OBS
hed_UT          =	UTC
hed_SideralTime =	LST
hed_telescope	=	TELESCOP
GAIN_value	=	0.77
RON_value	=	11.10
hed_instrume	=	INSTRUME
hed_airmass	=	AIRMASS
datamin_value   =	-100
datamax_value   =	60000
hed_slitw       =	SLIT
hed_lampid      =	LMP_ID
hed_biassec     =	BIASSEC
hed_trimsec     =	TRIMSEC
