hed_RA		=	HIERARCH FPA.RA
hed_DEC		=	HIERARCH FPA.DEC
hed_date	=	SHUTOUTC
hed_filter1	=	HIERARCH FPA.FILTER
hed_grism	=	ALGRNM
hed_object	=	HIERARCH FPA.OBJECT
hed_exptime	=	EXPTIME
hed_imagetyp	=	EXTTYPE
hed_expstar     =	EXPSTART
hed_JulianD	=	MJD-OBS
hed_UT  	=	SHUTOUTC
hed_SideralTime =	ST
hed_telescope	=	TELESCOP
GAIN_value      =	HIERARCH CELL.GAIN
RON_value       =	HIERARCH CELL.READNOISE
hed_instrume    =	PSCAMERA
hed_airmass     =	AIRMASS
datamin_value   =	-200
datamax_value   =	23000
hed_OBSMODE	=	OBS_MODE
hed_chip	=	FPPOS
